###########################
#@........................#
#.........................#
#.........................#
#.........................#
#.........................#
#.........................#
#..............X..........#
#.........................#
#.........................#
#.........................#
#.........................#
#.........................#
###########################